access         Native	native/sys_access.c	int	(string path, int mode)
chdir          Native	native/sys_chdir.c	int	(string path)
chmod          Native	native/sys_chmod.c	int	(string path, int mode)
chown          Native	native/sys_chown.c	int	(string path, int owner)
close          Native	native/sys_close.c	int	(int fd)
closedir       Native	native/sys_closedir.c	int	(int fd)
creat          Native	native/sys_creat.c	int	(string path, int mode)
dup            Native	native/sys_dup.c	int	(int fd)
dup2           Native	native/sys_dup2.c	int	(int fd, int fd2)
exec           Native	native/sys_exec.c	int	(string path, int narg, void *args, int nenv, void *envp)
execl          Library	native/sys_exec_sub.c	int	(void)
execle         Library	native/sys_exec_sub.c	int	(void)
execlp         Library	native/sys_exec_sub.c	int	(void)
execv          Library	native/sys_exec_sub.c	int	(void)
execve         Library	native/sys_exec_sub.c	int	(void)
execvp         Library	native/sys_exec_sub.c	int	(void)
_exit          Native	native/sys_exit.c	int	(void)
fcntl          Native	native/sys_fcntl.c	int	(int cmd, void *arg)
fork           Native	native/sys_fork.c	int	(void)
fseek          Library	native/sys_fseek.c	int	(int fd, int offset, int mode)
fstat          Library	native/sys_fstat.c	int	(int fd, struct stat *st)
stat	       Library  native/sys_fstat.c	int	(stirng path, struct stat *st)
lstat	       Library  native/sys_fstat.c	int	(stirng path, struct stat *st)
getcwd         Native	native/sys_getcwd.c	int	(string pwd)
getegid        Native	native/sys_getegid.c	int	(void)		
getenv         Native	native/sys_getenv.c	int	(void)
geteuid        Native	native/sys_geteuid.c	int	(void)
getgid         Native	native/sys_getgid.c	int	(void)
getgrgid       Native	native/sys_getgrgid.c	int	(void)
getgrnam       Native	native/sys_getgrnam.c	int	(string group)
getgroups      Native	native/sys_getgroups.c	int	(string group)
getlogin       Native	native/sys_getlogin.c	int	(string login)
getpgrp        Native	native/sys_getpgrp.c	int	(void)
getpid         Native	native/sys_getpid.c	int	(void)
getppid        Native	native/sys_getppid.c	int	(void)
getuid         Native	native/sys_getuid.c	int	(void)
kill           Native	native/sys_kill.c	int	(int pid)
link           Native	native/sys_link.c	int	(string src, string dst)
lseek          Native	native/sys_lseek.c	int	(int fd, int offset, int mode)
mkdir          Native	native/sys_mkdir.c	int	(string path, int mode)
mkfifo         Native	native/sys_mkfifo.c	int	(string path, int mode)
open           Native	native/sys_open.c	int	(string path, int mode)
opendir        Native	native/sys_opendir.c	int	(string path, int mode)
pause          Native	native/sys_pause.c	int	(void)
pipe           Native	native/sys_pipe.c	int	(int fds[2])
read           Native	native/sys_read.c	int	(int fd, void *buf, int size)
readdir        Native	native/sys_readdir.c	int	(int fd, struct dirent *dirp, int count)
remove         Native	native/sys_remove.c	int	(string path)
rename         Native	native/sys_rename.c	int	(string src, string dst)
rewind         Library	stdio/rewind.c		int	(int fd)
rewinddir      Library	stdio/rewinddir.c	int	(DIR *dirp)
rmdir          Native	native/sys_rmdir.c	int	(string path)
setgid         Native   native/sys_setgid.c	int	(int gid)
setpgid        Native	native/sys_setpgid.c	int	(int gid)
setsid         Native	native/sys_setsid.c	int	(int void)
setuid         Native	native/sys_setuid.c	int	(int uid)
sigaction      Native	native/sys_sigaction.c	int	(int signo, struct sigaction *action, struct sigaction *oldaction)
sigaddset      Native	native/sys_sigaddset.c	int	(sigset_t *set, int signo)
sigdelset      Native	native/sys_sigdelset.c	int	(sigset_t *set, int signo)
sigemptyset    Native	native/sys_sigemptyset.c int	(sigset_t *set)
sigfillset     Native	native/sys_sigfillset.c	int	(sigset_t *set)
sigismember    Native	native/sys_sigismember.c int	(sigset_t *set, int signo)
siglongjmp     Native	native/sys_siglongjmp.c	int	(void)
sigpending     Native	native/sys_sigpending.c	int	(void)
sigprocmask    Native	native/sys_sigprocmask.c int	(int how, sigset_t *new, sigset_t *old)
sigsetjmp      Native	native/sys_sigsetjmp.c	int	(void)
sigsuspend     Native	native/sys_sigsuspend.c	int	(void)
sleep          Native	native/sys_sleep.c	int	(int second)
stat           Native	native/sys_fstat.c	int	(int fd, struct stat *st)
time           Native	native/sys_time.c	int	(time_t *tm)
times          Native	native/sys_times.c	clock_t	(struct tms *buf)
ttyname        Native	native/sys_ttyname.c	int	(string name)
tzset          Library	native/sys_tzset.c	void	(void)
umask          Native	native/sys_umask.c	int	(int mask)
uname          Native	native/sys_uname.c	int	(string buf)
unlink         Native	native/sys_unlink.c	int	(string path)
utime          Native	native/sys_utime.c	int	(string path, struct utimbuf *buf)
waitpid        Native	native/sys_waitpid.c	int	(pid_t pid, int *status, int option)
write          Native	native/sys_write.c	int	(int fd, void *buf, int length)
